Top-Level Topics	Utility Buckets
/Arts & Entertainment	Standard
/Autos & Vehicles	High
/Beauty & Fitness	High
/Books & Literature	Standard
/Business & Industrial	Standard
/Computers & Electronics	High
/Finance	High
/Food & Drink	High
/Games	High
/Hobbies & Leisure	High
/Home & Garden	High
/Internet & Telecom	Standard
/Jobs & Education	Standard
/Law & Government	High
/News	Standard
/Online Communities	Standard
/People & Society	High
/Pets & Animals	High
/Real Estate	High
/Shopping	High
/Sports	High
/Travel & Transportation	High